KMC = "countries/Guominjun.txt"
BWA = "countries/British West Africa.txt"
LIV = "countries/Livonia.txt"
SCH = "countries/Sichuan Clique.txt"
BAV = "countries/Bavaria.txt"
WUR = "countries/Baden Wurttemberg.txt"
AOF = "countries/French West Africa.txt"
AEF = "countries/French East Africa.txt"
PRM = "countries/Portugese Monarchy.txt"
ALG = "countries/Algeria.txt"
BFA = "countries/Burkina Faso.txt"
BOS = "countries/Bosnia.txt"
BUR = "countries/Burma.txt"
CAT = "countries/Catalonia.txt"
CEA = "countries/Central Africa.txt"
CEY = "countries/Ceylon.txt"
CIV = "countries/Cote d'Ivoire.txt"
CNR = "countries/DR Congo.txt"
CVG = "countries/Cape Verde Guinea.txt"
SAR = "countries/Sarawak.txt"
CYP = "countries/Cyprus.txt"
ERT = "countries/Eritrea.txt"
FLN = "countries/Flanders.txt"
FNG = "countries/Fengtian Clique.txt"
GAB = "countries/Gabon.txt"
GHA = "countries/Ghana.txt"
GNE = "countries/Guinea.txt"
INC = "countries/Indochina.txt"
KAM = "countries/Cameroon.txt"
KUR = "countries/Kurdistan.txt"
MAG = "countries/Madagascar.txt"
MAL = "countries/Mali.txt"
MOR = "countries/Morocco.txt"
MOZ = "countries/Mozambique.txt"
MRT = "countries/Mauritania.txt"
NAM = "countries/Namibia.txt"
NER = "countries/Niger.txt"
NGR = "countries/Nigeria.txt"
QUE = "countries/Quebec.txt"
RHI = "countries/Rhenish Republic.txt"
SCT = "countries/Scotland.txt"
SEN = "countries/Senegal.txt"
SLV = "countries/Slovenia.txt"
SOM = "countries/Somalia.txt"
SUD = "countries/Sudan.txt"
TNZ = "countries/Tanzania.txt"
TUA = "countries/Tuareg.txt"
TUN = "countries/Tunisia.txt"
UGA = "countries/Uganda.txt"
WLL = "countries/Wallonia.txt"
ZAM = "countries/Zambia.txt"
BRD = "countries/Burundi.txt"
DAH = "countries/Dahomey.txt"
TOG = "countries/Togoland.txt"
KTG = "countries/Katanga.txt"
MLW = "countries/Malawi.txt"
RWA = "countries/Rwanda.txt"
BRT = "countries/Barotseland.txt"
SML = "countries/Somaliland.txt"
UAE = "countries/United Arab Emirates.txt"
ZAN = "countries/Zanzibar.txt"
ADE = "countries/Aden.txt"
SLE = "countries/Sierra Leone.txt"
NEW = "countries/Newfoundland.txt"
WTH = "countries/Wathanistan.txt"
HYD = "countries/Hyderabad.txt"
JKA = "countries/Jammu and Kashmir.txt"
MYS = "countries/Mysore.txt"
TRV = "countries/Travancore.txt"
GWL = "countries/Gwalior.txt"
CIN = "countries/Communist India.txt"
SKM = "countries/Sikkim.txt"
MNP = "countries/Manipur.txt"
BAR = "countries/Baroda.txt"
TRP = "countries/Tripura.txt"
BGL = "countries/Bengal.txt"
BMR = "countries/Burmese Revolt.txt"
EAF = "countries/East Africa Federation.txt"
AWR = "countries/Austrian Workers Republic.txt"
MLT = "countries/Malta.txt"
GUY = "countries/Guyana.txt"
CFA = "countries/Caribbean.txt"
VNZ = "countries/Venice.txt"
SRD = "countries/Sardinia.txt"
SRI = "countries/Socialist Italy.txt"
ILN = "countries/Italian Legion.txt"
IEA = "countries/Italian East Africa.txt"
INA = "countries/Italian North Africa.txt"
TRK = "countries/Turkestan.txt"
TCS = "countries/Transcaspia.txt"
KHO = "countries/Khorasan.txt"
KHU = "countries/Khuzestan.txt"
IMR = "countries/VMRO Revolt.txt"
STJ = "countries/Croatian Rebels.txt"
LAB = "countries/Albona.txt"
MKE = "countries/Macedonia.txt"
SIC = "countries/Sicily.txt"
WAL = "countries/Wales.txt"
JOH = "countries/Johor.txt"
KED = "countries/Kedah.txt"
TRG = "countries/Terengganu.txt"
KEL = "countries/Kelantan.txt"
PAH = "countries/Pahang.txt"
PRK = "countries/Perak.txt"
PLS = "countries/Perlis.txt"
SLG = "countries/Selangor.txt"
NGS = "countries/Negeri Sembilan.txt"
BRU = "countries/Brunei.txt"
RSE = "countries/Reactionary Serbia.txt"
MBU = "countries/Monarchist Bulgaria.txt"
SWK = "countries/RightSweden.txt"
KOS = "countries/Kosovo.txt"
BSE = "countries/Bosnian Serbs.txt"
SHA = "countries/Shandong.txt"
ZHO = "countries/Zhongying Clique.txt"
NAN = "countries/Nanjing Government.txt"
POL = "countries/Poland.txt"
RSH = "countries/Republican Albania.txt"
CRB = "countries/Central Revolution Base.txt"
HLF = "countries/Hailufeng.txt"
OTT = "countries/Ottomans.txt"
VNA = "countries/Annamite Rebellion.txt"
CFR = "countries/Communist France.txt"
WES = "countries/Westphalia.txt"
HAN = "countries/Hanover.txt"
SAX = "countries/Saxony.txt"
PRS = "countries/Prussia.txt"
BER = "countries/Berlin.txt"
PRI = "countries/Priamur.txt"
